mol	mol
bps	bps
m/h	m/h
m/s	m/s
m/m	m/m
g/l	g/l
N/m2	N/m2
cd	cd
Pa	Pa
Ω	Ω
Wb	Wb
Hz	Hz
sr	sr
ha	ha
cc	cc
m	m
g	g
N	N
l	l
s	s
A	A
K	K
J	J
W	W
C	C
V	V
F	F
S	S
T	T
H	H
Sv	Sv
B	Byte
Bq	Bq
dB	dB
pixel	pixel
cal	cal